{
    "blocks":
    [
        "eda425605302",
        "5655135ebc9c",
        "2f9e4658c3f0",
        "2cf322858b22",
        "aa2479679a33"
    ],
    "models":
    [
        "45414f98880b"
    ],
    "items":
    [
        "260dcba928cc",
        "d5fa849d6f22",
        "4c302ab984ab",
        "6a6acc827996",
        "2343e088d68e",
        "df152deb3827",
        "1b8a66d5ea06",
        "f51247b5ad4a",
        "d468bdf982fc",
        "51ff41b96e6f",
        "2cc2706ddcfd",
        "0e71106b7ec0",
        "39d0743da890",
        "e55b78e535f0",
        "1e78faf563f2",
        "eb0a5f758f6c",
        "e42c547132da",
        "aa16be8a8fc4",
        "7e9dadd62035",
        "6c21254fbb9f",
        "0249fafd08c3",
        "5b8b8b7b484d",
        "f7fc90777b90",
        "48ccd5f00fe3",
        "ded4fc80cb1e",
        "80fcc504ecf6"
    ]
}